8
0 0 0 0 0 0 0 0
0 0 0 0 0 0 0 0
8 9 9 9 9 9 9 8
9 1 1 1 1 1 2 9
9 1 1 1 3 3 5 9
9 1 1 9 1 1 2 9
8 9 9 9 9 9 9 8
0 0 0 0 0 0 0 0