8
8 9 9 9 8 9 9 8
9 5 1 2 1 1 1 9
9 2 3 4 3 4 2 9
8 3 1 2 3 2 1 9
9 2 1 4 1 1 1 8
9 1 3 3 3 3 3 9
9 2 1 2 1 2 1 9
8 9 9 8 9 9 9 8